Chrysochloris_asiatica	Afrotheria
Echinops_telfairi	Afrotheria
Elephantulus_edwardii	Afrotheria
Elephas_maximus	Afrotheria
Loxodonta_africana	Afrotheria
Orycteropus_afer	Afrotheria
Trichechus_manatus	Afrotheria
Bison_bison	Artiodactyla
Bos_indicus	Artiodactyla
Bos_javanicus	Artiodactyla
Bos_mutus	Artiodactyla
Bos_taurus	Artiodactyla
Bubalus_bubalis	Artiodactyla
Bubalus_kerabau	Artiodactyla
Budorcas_taxicolor	Artiodactyla
Camelus_bactrianus	Artiodactyla
Camelus_dromedarius	Artiodactyla
Camelus_ferus	Artiodactyla
Capra_hircus	Artiodactyla
Cervus_canadensis	Artiodactyla
Cervus_elaphus	Artiodactyla
Dama_dama	Artiodactyla
Hippopotamus_amphibius	Artiodactyla
Moschus_berezovskii	Artiodactyla
Muntiacus_reevesi	Artiodactyla
Oryx_dammah	Artiodactyla
Ovis_aries	Artiodactyla
Phacochoerus_africanus	Artiodactyla
Sus_scrofa	Artiodactyla
Vicugna_pacos	Artiodactyla
Acinonyx_jubatus	Carnivora
Ailuropoda_melanoleuca	Carnivora
Callorhinus_ursinus	Carnivora
Canis_lupus	Carnivora
Enhydra_lutris	Carnivora
Eumetopias_jubatus	Carnivora
Felis_catus	Carnivora
Halichoerus_grypus	Carnivora
Hyaena_hyaena	Carnivora
Leopardus_geoffroyi	Carnivora
Leptonychotes_weddellii	Carnivora
Lontra_canadensis	Carnivora
Lutra_lutra	Carnivora
Lynx_canadensis	Carnivora
Lynx_rufus	Carnivora
Meles_meles	Carnivora
Mirounga_angustirostris	Carnivora
Mirounga_leonina	Carnivora
Mustela_erminea	Carnivora
Mustela_lutreola	Carnivora
Mustela_nigripes	Carnivora
Mustela_putorius	Carnivora
Neofelis_nebulosa	Carnivora
Neogale_vison	Carnivora
Neomonachus_schauinslandi	Carnivora
Nyctereutes_procyonoides	Carnivora
Odobenus_rosmarus	Carnivora
Panthera_leo	Carnivora
Panthera_onca	Carnivora
Panthera_pardus	Carnivora
Panthera_tigris	Carnivora
Panthera_uncia	Carnivora
Phoca_vitulina	Carnivora
Prionailurus_bengalensis	Carnivora
Prionailurus_viverrinus	Carnivora
Puma_concolor	Carnivora
Puma_yagouaroundi	Carnivora
Suricata_suricatta	Carnivora
Ursus_americanus	Carnivora
Ursus_arctos	Carnivora
Ursus_maritimus	Carnivora
Vulpes_lagopus	Carnivora
Vulpes_vulpes	Carnivora
Zalophus_californianus	Carnivora
Balaenoptera_acutorostrata	Cetacea
Balaenoptera_musculus	Cetacea
Balaenoptera_ricei	Cetacea
Delphinapterus_leucas	Cetacea
Delphinus_delphis	Cetacea
Eubalaena_glacialis	Cetacea
Globicephala_melas	Cetacea
Kogia_breviceps	Cetacea
Lagenorhynchus_albirostris	Cetacea
Lagenorhynchus_obliquidens	Cetacea
Lipotes_vexillifer	Cetacea
Mesoplodon_densirostris	Cetacea
Monodon_monoceros	Cetacea
Neophocaena_asiaeorientalis	Cetacea
Orcinus_orca	Cetacea
Phocoena_phocoena	Cetacea
Phocoena_sinus	Cetacea
Physeter_catodon	Cetacea
Tursiops_truncatus	Cetacea
Artibeus_jamaicensis	Chiroptera
Desmodus_rotundus	Chiroptera
Eptesicus_fuscus	Chiroptera
Hipposideros_armiger	Chiroptera
Miniopterus_natalensis	Chiroptera
Molossus_molossus	Chiroptera
Myotis_brandtii	Chiroptera
Myotis_daubentonii	Chiroptera
Myotis_davidii	Chiroptera
Myotis_lucifugus	Chiroptera
Myotis_myotis	Chiroptera
Phyllostomus_discolor	Chiroptera
Phyllostomus_hastatus	Chiroptera
Pipistrellus_kuhlii	Chiroptera
Pteronotus_mesoamericanus	Chiroptera
Pteropus_alecto	Chiroptera
Pteropus_giganteus	Chiroptera
Pteropus_vampyrus	Chiroptera
Rhinolophus_ferrumequinum	Chiroptera
Rousettus_aegyptiacus	Chiroptera
Saccopteryx_bilineata	Chiroptera
Saccopteryx_leptura	Chiroptera
Sturnira_hondurensis	Chiroptera
Dasypus_novemcinctus	Cingulata
Cynocephalus_volans	Dermoptera
Galeopterus_variegatus	Dermoptera
Erinaceus_europaeus	Eulipotphyla
Condylura_cristata	Eulipotyphla
Sorex_araneus	Eulipotyphla
Sorex_fumeus	Eulipotyphla
Suncus_etruscus	Eulipotyphla
Talpa_occidentalis	Eulipotyphla
Chionomys_nivalis	Lagomorpha
Lepus_europaeus	Lagomorpha
Ochotona_curzoniae	Lagomorpha
Ochotona_princeps	Lagomorpha
Oryctolagus_cuniculus	Lagomorpha
Antechinus_flavipes	Marsupialia
Dromiciops_gliroides	Marsupialia
Gracilinanus_agilis	Marsupialia
Monodelphis_domestica	Marsupialia
Phascolarctos_cinereus	Marsupialia
Sarcophilus_harrisii	Marsupialia
Trichosurus_vulpecula	Marsupialia
Vombatus_ursinus	Marsupialia
Ceratotherium_simum	Perissodactyla
Diceros_bicornis	Perissodactyla
Equus_asinus	Perissodactyla
Equus_caballus	Perissodactyla
Equus_przewalskii	Perissodactyla
Equus_quagga	Perissodactyla
Manis_javanica	Pholidota
Manis_pentadactyla	Pholidota
Choloepus_didactylus	Pilosa
Aotus_nancymaae	Primates
Callithrix_jacchus	Primates
Carlito_syrichta	Primates
Cebus_imitator	Primates
Cercocebus_atys	Primates
Chlorocebus_sabaeus	Primates
Colobus_angolensis	Primates
Gorilla_gorilla	Primates
Homo_sapiens	Primates
Hylobates_moloch	Primates
Lemur_catta	Primates
Macaca_fascicularis	Primates
Macaca_mulatta	Primates
Macaca_nemestrina	Primates
Macaca_thibetana	Primates
Mandrillus_leucophaeus	Primates
Microcebus_murinus	Primates
Nomascus_leucogenys	Primates
Nycticebus_coucang	Primates
Otolemur_garnettii	Primates
Pan_paniscus	Primates
Pan_troglodytes	Primates
Papio_anubis	Primates
Piliocolobus_tephrosceles	Primates
Pongo_abelii	Primates
Pongo_pygmaeus	Primates
Propithecus_coquereli	Primates
Rhinopithecus_bieti	Primates
Rhinopithecus_roxellana	Primates
Saimiri_boliviensis	Primates
Sapajus_apella	Primates
Symphalangus_syndactylus	Primates
Theropithecus_gelada	Primates
Trachypithecus_francoisi	Primates
Acomys_russatus	Rodentia
Apodemus_sylvaticus	Rodentia
Arvicanthis_niloticus	Rodentia
Arvicola_amphibius	Rodentia
Castor_canadensis	Rodentia
Cavia_porcellus	Caviomorpha
Chinchilla_lanigera	Caviomorpha
Cricetulus_griseus	Rodentia
Dipodomys_ordii	Rodentia
Dipodomys_spectabilis	Rodentia
Fukomys_damarensis	Rodentia
Grammomys_surdaster	Rodentia
Heterocephalus_glaber	Rodentia
Ictidomys_tridecemlineatus	Rodentia
Marmota_flaviventris	Rodentia
Marmota_marmota	Rodentia
Marmota_monax	Rodentia
Mastomys_coucha	Rodentia
Meriones_unguiculatus	Rodentia
Mesocricetus_auratus	Rodentia
Microtus_fortis	Rodentia
Microtus_ochrogaster	Rodentia
Microtus_oregoni	Rodentia
Mus_caroli	Rodentia
Mus_musculus	Rodentia
Mus_pahari	Rodentia
Myodes_glareolus	Rodentia
Nannospalax_galili	Rodentia
Octodon_degus	Caviomorpha
Onychomys_torridus	Rodentia
Perognathus_longimembris	Rodentia
Peromyscus_californicus	Rodentia
Peromyscus_eremicus	Rodentia
Peromyscus_leucopus	Rodentia
Peromyscus_maniculatus	Rodentia
Phodopus_roborovskii	Rodentia
Psammomys_obesus	Rodentia
Rattus_norvegicus	Rodentia
Rattus_rattus	Rodentia
Sciurus_carolinensis	Rodentia
Urocitellus_parryii	Rodentia
Tupaia_chinensis	Scandentia
